0 0 0 0 0 0 0 1 0 0 0 0 0 0 0 1 0 0 1 0
0 0 1 0 1 0 0 1 1 0 0 1 0 0 0 0 0 0 0 1
0 0 1 2 0 0 0 0 1 0 0 0 0 1 0 0 0 0 2 0
1 1 0 0 0 0 0 0 0 0 0 1 0 0 0 0 0 1 0 0
2 0 0 0 1 0 0 1 2 0 0 0 0 0 0 0 1 0 0 0
0 0 0 0 0 0 1 1 0 0 0 0 0 0 0 0 0 1 1 1
0 0 0 1 0 0 0 0 0 0 1 0 0 0 0 0 0 0 1 0
0 0 0 0 1 1 0 1 0 0 0 0 0 1 0 0 0 0 0 1
0 0 0 0 0 1 0 0 0 0 0 0 1 0 0 0 0 1 0 0
0 0 1 0 0 0 1 0 0 0 0 1 0 0 0 1 0 1 0 0
0 1 1 0 0 1 0 0 0 1 0 0 0 0 0 0 0 0 1 0
1 0 0 1 0 1 0 0 1 0 1 0 0 0 0 0 0 0 0 0
0 1 1 0 0 0 0 0 0 0 0 0 0 0 0 0 0 0 1 1
0 0 1 0 0 1 0 1 0 0 0 0 1 0 0 0 0 0 0 0
0 1 0 0 0 1 1 0 0 0 1 0 0 0 1 0 0 0 0 1
0 1 0 0 0 0 0 0 0 0 0 0 0 0 1 1 0 0 0 2
0 1 1 0 0 1 0 0 0 0 0 0 0 0 0 0 0 0 0 1
1 0 0 0 0 0 1 0 1 0 2 0 0 0 0 0 0 0 0 0
0 0 0 2 0 0 0 0 1 0 0 0 0 0 0 1 0 0 1 0
0 0 0 0 0 0 0 0 1 0 0 0 0 0 0 0 0 1 0 1

SENSORS GAINS:
(2, 3): {0: 0, 1: 3, 2: 6, 3: 8, 4: 9}
(2, 18): {0: 0, 1: 4, 2: 6, 3: 7, 4: 8}
(4, 0): {0: 0, 1: 2, 2: 4, 3: 6, 4: 7, 5: 8, 6: 9}
(4, 8): {0: 0, 1: 3, 2: 5, 3: 7, 4: 9, 5: 11, 6: 13, 7: 14}
(15, 19): {0: 0, 1: 1, 2: 2, 3: 3}
(17, 10): {0: 0, 1: 4, 2: 7, 3: 8, 4: 9, 5: 10, 6: 11, 7: 12, 8: 13, 9: 14}
(18, 3): {0: 0, 1: 4, 2: 7, 3: 10, 4: 12, 5: 13, 6: 14}

SENSORS GAINS at max level {MAX_SENSOR_CAPACITY}:
(2, 3): {0: 0, 1: 3, 2: 6, 3: 8, 4: 9}
(2, 18): {0: 0, 1: 4, 2: 6, 3: 7, 4: 8}
(4, 0): {0: 0, 1: 2, 2: 4, 3: 6, 4: 7, 5: 8}
(4, 8): {0: 0, 1: 3, 2: 5, 3: 7, 4: 9, 5: 11}
(15, 19): {0: 0, 1: 1, 2: 2, 3: 3}
(17, 10): {0: 0, 1: 4, 2: 7, 3: 8, 4: 9, 5: 10}
(18, 3): {0: 0, 1: 4, 2: 7, 3: 10, 4: 12, 5: 13}

+-----+-----+-----+-----+-----+-----+-----+-----+-----+-----+-----+-----+-----+-----+-----+-----+-----+-----+-----+-----+-----+-----+
|     |  0  |  1  |  2  |  3  |  4  |  5  |  6  |  7  |  8  |  9  | 10  | 11  | 12  | 13  | 14  | 15  | 16  | 17  | 18  | 19  |     |
+-----+-----+-----+-----+-----+-----+-----+-----+-----+-----+-----+-----+-----+-----+-----+-----+-----+-----+-----+-----+-----+-----+
|  0  |  0  |  0  |  0  |  0  |  0  |  0  |  0  |  1  |  0  |  0  |  0  |  0  |  0  |  0  |  0  |  1  |  0  |  0  |  1  |  0  |  0  |
+-----+-----+-----+-----+-----+-----+-----+-----+-----+-----+-----+-----+-----+-----+-----+-----+-----+-----+-----+-----+-----+-----+
|  1  |  0  |  0  |  1  |  0  |  1  |  0  |  0  |  1  |  1  |  0  |  0  |  1  |  0  |  0  |  0  |  0  |  0  |  0  |  0  |  1  |  1  |
+-----+-----+-----+-----+-----+-----+-----+-----+-----+-----+-----+-----+-----+-----+-----+-----+-----+-----+-----+-----+-----+-----+
|  2  |  0  |  0  |  1  |  2  |  0  |  0  |  0  |  0  |  1  |  0  |  0  |  0  |  0  |  1  |  0  |  0  |  0  |  0  |  2  |  0  |  2  |
+-----+-----+-----+-----+-----+-----+-----+-----+-----+-----+-----+-----+-----+-----+-----+-----+-----+-----+-----+-----+-----+-----+
|  3  |  1  |  1  |  0  |  0  |  0  |  0  |  0  |  0  |  0  |  0  |  0  |  1  |  0  |  0  |  0  |  0  |  0  |  1  |  0  |  0  |  3  |
+-----+-----+-----+-----+-----+-----+-----+-----+-----+-----+-----+-----+-----+-----+-----+-----+-----+-----+-----+-----+-----+-----+
|  4  |  2  |  0  |  0  |  0  |  1  |  0  |  0  |  1  |  2  |  0  |  0  |  0  |  0  |  0  |  0  |  0  |  1  |  0  |  0  |  0  |  4  |
+-----+-----+-----+-----+-----+-----+-----+-----+-----+-----+-----+-----+-----+-----+-----+-----+-----+-----+-----+-----+-----+-----+
|  5  |  0  |  0  |  0  |  0  |  0  |  0  |  1  |  1  |  0  |  0  |  0  |  0  |  0  |  0  |  0  |  0  |  0  |  1  |  1  |  1  |  5  |
+-----+-----+-----+-----+-----+-----+-----+-----+-----+-----+-----+-----+-----+-----+-----+-----+-----+-----+-----+-----+-----+-----+
|  6  |  0  |  0  |  0  |  1  |  0  |  0  |  0  |  0  |  0  |  0  |  1  |  0  |  0  |  0  |  0  |  0  |  0  |  0  |  1  |  0  |  6  |
+-----+-----+-----+-----+-----+-----+-----+-----+-----+-----+-----+-----+-----+-----+-----+-----+-----+-----+-----+-----+-----+-----+
|  7  |  0  |  0  |  0  |  0  |  1  |  1  |  0  |  1  |  0  |  0  |  0  |  0  |  0  |  1  |  0  |  0  |  0  |  0  |  0  |  1  |  7  |
+-----+-----+-----+-----+-----+-----+-----+-----+-----+-----+-----+-----+-----+-----+-----+-----+-----+-----+-----+-----+-----+-----+
|  8  |  0  |  0  |  0  |  0  |  0  |  1  |  0  |  0  |  0  |  0  |  0  |  0  |  1  |  0  |  0  |  0  |  0  |  1  |  0  |  0  |  8  |
+-----+-----+-----+-----+-----+-----+-----+-----+-----+-----+-----+-----+-----+-----+-----+-----+-----+-----+-----+-----+-----+-----+
|  9  |  0  |  0  |  1  |  0  |  0  |  0  |  1  |  0  |  0  |  0  |  0  |  1  |  0  |  0  |  0  |  1  |  0  |  1  |  0  |  0  |  9  |
+-----+-----+-----+-----+-----+-----+-----+-----+-----+-----+-----+-----+-----+-----+-----+-----+-----+-----+-----+-----+-----+-----+
| 10  |  0  |  1  |  1  |  0  |  0  |  1  |  0  |  0  |  0  |  1  |  0  |  0  |  0  |  0  |  0  |  0  |  0  |  0  |  1  |  0  | 10  |
+-----+-----+-----+-----+-----+-----+-----+-----+-----+-----+-----+-----+-----+-----+-----+-----+-----+-----+-----+-----+-----+-----+
| 11  |  1  |  0  |  0  |  1  |  0  |  1  |  0  |  0  |  1  |  0  |  1  |  0  |  0  |  0  |  0  |  0  |  0  |  0  |  0  |  0  | 11  |
+-----+-----+-----+-----+-----+-----+-----+-----+-----+-----+-----+-----+-----+-----+-----+-----+-----+-----+-----+-----+-----+-----+
| 12  |  0  |  1  |  1  |  0  |  0  |  0  |  0  |  0  |  0  |  0  |  0  |  0  |  0  |  0  |  0  |  0  |  0  |  0  |  1  |  1  | 12  |
+-----+-----+-----+-----+-----+-----+-----+-----+-----+-----+-----+-----+-----+-----+-----+-----+-----+-----+-----+-----+-----+-----+
| 13  |  0  |  0  |  1  |  0  |  0  |  1  |  0  |  1  |  0  |  0  |  0  |  0  |  1  |  0  |  0  |  0  |  0  |  0  |  0  |  0  | 13  |
+-----+-----+-----+-----+-----+-----+-----+-----+-----+-----+-----+-----+-----+-----+-----+-----+-----+-----+-----+-----+-----+-----+
| 14  |  0  |  1  |  0  |  0  |  0  |  1  |  1  |  0  |  0  |  0  |  1  |  0  |  0  |  0  |  1  |  0  |  0  |  0  |  0  |  1  | 14  |
+-----+-----+-----+-----+-----+-----+-----+-----+-----+-----+-----+-----+-----+-----+-----+-----+-----+-----+-----+-----+-----+-----+
| 15  |  0  |  1  |  0  |  0  |  0  |  0  |  0  |  0  |  0  |  0  |  0  |  0  |  0  |  0  |  1  |  1  |  0  |  0  |  0  |  2  | 15  |
+-----+-----+-----+-----+-----+-----+-----+-----+-----+-----+-----+-----+-----+-----+-----+-----+-----+-----+-----+-----+-----+-----+
| 16  |  0  |  1  |  1  |  0  |  0  |  1  |  0  |  0  |  0  |  0  |  0  |  0  |  0  |  0  |  0  |  0  |  0  |  0  |  0  |  1  | 16  |
+-----+-----+-----+-----+-----+-----+-----+-----+-----+-----+-----+-----+-----+-----+-----+-----+-----+-----+-----+-----+-----+-----+
| 17  |  1  |  0  |  0  |  0  |  0  |  0  |  1  |  0  |  1  |  0  |  2  |  0  |  0  |  0  |  0  |  0  |  0  |  0  |  0  |  0  | 17  |
+-----+-----+-----+-----+-----+-----+-----+-----+-----+-----+-----+-----+-----+-----+-----+-----+-----+-----+-----+-----+-----+-----+
| 18  |  0  |  0  |  0  |  2  |  0  |  0  |  0  |  0  |  1  |  0  |  0  |  0  |  0  |  0  |  0  |  1  |  0  |  0  |  1  |  0  | 18  |
+-----+-----+-----+-----+-----+-----+-----+-----+-----+-----+-----+-----+-----+-----+-----+-----+-----+-----+-----+-----+-----+-----+
| 19  |  0  |  0  |  0  |  0  |  0  |  0  |  0  |  0  |  1  |  0  |  0  |  0  |  0  |  0  |  0  |  0  |  0  |  1  |  0  |  1  | 19  |
+-----+-----+-----+-----+-----+-----+-----+-----+-----+-----+-----+-----+-----+-----+-----+-----+-----+-----+-----+-----+-----+-----+
|     |  0  |  1  |  2  |  3  |  4  |  5  |  6  |  7  |  8  |  9  | 10  | 11  | 12  | 13  | 14  | 15  | 16  | 17  | 18  | 19  |     |
+-----+-----+-----+-----+-----+-----+-----+-----+-----+-----+-----+-----+-----+-----+-----+-----+-----+-----+-----+-----+-----+-----+
ROWS: 20 COLUMNS: 20 TOTAL: 400
WALLS 80: [(0, 7), (0, 15), (0, 18), (1, 2), (1, 4), (1, 7), (1, 8), (1, 11), (1, 19), (2, 2), (2, 8), (2, 13), (3, 0), (3, 1), (3, 11), (3, 17), (4, 4), (4, 7), (4, 16), (5, 6), (5, 7), (5, 17), (5, 18), (5, 19), (6, 3), (6, 10), (6, 18), (7, 4), (7, 5), (7, 7), (7, 13), (7, 19), (8, 5), (8, 12), (8, 17), (9, 2), (9, 6), (9, 11), (9, 15), (9, 17), (10, 1), (10, 2), (10, 5), (10, 9), (10, 18), (11, 0), (11, 3), (11, 5), (11, 8), (11, 10), (12, 1), (12, 2), (12, 18), (12, 19), (13, 2), (13, 5), (13, 7), (13, 12), (14, 1), (14, 5), (14, 6), (14, 10), (14, 14), (14, 19), (15, 1), (15, 14), (15, 15), (16, 1), (16, 2), (16, 5), (16, 19), (17, 0), (17, 6), (17, 8), (18, 8), (18, 15), (18, 18), (19, 8), (19, 17), (19, 19)]
SENSORS 7: [(2, 3), (2, 18), (4, 0), (4, 8), (15, 19), (17, 10), (18, 3)]
Drone at: 7, 12

MINIMUM DISTANCES BETWEEN SENSORS:
(2, 3): {(2, 3): 0, (2, 18): 19, (4, 0): 5, (4, 8): 7, (15, 19): 29, (17, 10): 22, (18, 3): 20}
(2, 18): {(2, 3): 19, (2, 18): 0, (4, 0): 22, (4, 8): 12, (15, 19): 20, (17, 10): 23, (18, 3): 31}
(4, 0): {(2, 3): 5, (2, 18): 22, (4, 0): 0, (4, 8): 10, (15, 19): 30, (17, 10): 23, (18, 3): 19}
(4, 8): {(2, 3): 7, (2, 18): 12, (4, 0): 10, (4, 8): 0, (15, 19): 22, (17, 10): 17, (18, 3): 19}
(15, 19): {(2, 3): 29, (2, 18): 20, (4, 0): 30, (4, 8): 22, (15, 19): 0, (17, 10): 11, (18, 3): 19}
(17, 10): {(2, 3): 22, (2, 18): 23, (4, 0): 23, (4, 8): 17, (15, 19): 11, (17, 10): 0, (18, 3): 10}
(18, 3): {(2, 3): 20, (2, 18): 31, (4, 0): 19, (4, 8): 19, (15, 19): 19, (17, 10): 10, (18, 3): 0}
MINIMUM DISTANCES BETWEEN START AND SENSORS:
{(2, 3): 14, (2, 18): 11, (4, 0): 15, (4, 8): 7, (15, 19): 17, (17, 10): 14, (18, 3): 20}